APPEARANCE	TST
CLEAR	RES
BACTERIA	TST
BILE PIGMENTS	TST
BILE SALTS	TST
BLOOD	TST
ABSENT	RES
BLOOD GROUP	TST
BLOOD UREA NITROGEN (BUN)	TST
CASTS	TST
COLOUR	TST
CRYSTALS	TST
EPITHELIAL CELLS	TST
GLUCOSE	TST
HbA1C	TST
KETONE BODIES	TST
/hpf	UNT
LDL/HDL	TST
NITRATE	TST
pH	TST
PLATELET MORPHOLOGY	TST
PUS CELLS	TST
QUANTITY	TST
R.B.Cs	TST
RBC MORPHOLOGY	TST
SPECIFIC GRAVITY	TST
SR. HDL	TST
SR. LDL	TST
mg/dL	UNT
ml	UNT
Adequate on Smear	RES
fl	UNT
SR. VLDL	TST
T.C./HDL	TST
UROBILINOGEN	TST
WBC MORPHOLOGY	TST
S.G.O.T	TST
Bilirubin	TST
S.G.P.T	TST
BASOPHILS	TST
IU/L	UNT
mg/mL	UNT
mg/L	UNT
25 - HYDROXYVITAMIN D	TST
δ-AMINO LEVULINIC ACID (δ-ALA)	TST
δ-ALA	TST
E.S.R.	TST
A/G RATIO	TST
T3	TST
T4	TST
TSH	TST
TRIGLYCERIDES	TST
CHOLESTEROL	TST
ABO GROUP	TST
SUGAR	TST
ABSOLUTE BASOPHIL COUNT	TST
thou/µL	UNT
/cmm	UNT
AFB STAIN	TST
ALK.Phosphatase	TST
ALBUMIN	TST
g/dL	UNT
Nil	UNT
U/L	UNT
IU/L	UNT
ALKALINE PHOSPHATASE	TST
Amorphous	TST
Amorphous Material	TST
AMOUNT	TST
HAZY	RES
cm.	UNT
Aortic Valve	TST
BACTERIA	TST
BACILLI	TST
x10^9/L	UNT
Cells/cu.mm	UNT
BILE PIGMENTS	TST
BILIRUBIN INDIRECT	TST
BILIRUBIN DIRECT	TST
BILIRUBIN TOTAL	TST
BLOOD SUGAR FASTING	TST
Blood Lead Level	TST
mcg/dl	UNT
BLOOD PRESSURE	TST
Blood Sugar (PP)	TST
Blood Sugar Random	TST
BLOOD UREA	TST
BLOOD UREA NITROGEN	TST
BMI	TST
kg/sqmts	UNT
mm/Hg	UNT
CALCIUM	TST
CHOLESTEROL	TST
COLOUR	TST
HAEMOGLOBIN	TST
COMPLETE BLOOD COUNT CBC	CAT
CONSISTENCY	TST
CREATININE	TST
DIFFERENTIAL COUNT	CAT
E.S.R.	TST
eGFR, Serum	TST
ESTIMATED AVERAGE GLUCOSE	TST
FAT GLOBULES	TST
GAMMA GLUTAMYL TRANSFERASE (GGT)	TST
GGT	TST
GLUCOSE (SUGAR) PP, Fluoride Plasma	TST
GLUCOSE, FASTING, NAF PLASMA	TST
GLUCOSE - ( POST PRANDIAL)	TST
%	UNT
x10^3 μ/L	UNT
GRANULOCYTES	TST
HAEMATOCRIT (PCV)	TST
HDL CHOLESTEROL	TST
L.D.L. : H.D.L.	TST
LDL CHOL / HDL CHOL RATIO	TST
LUCOCYTE ESTERASE	TST
M.C.H.	TST
M.C.H.C	TST
M.C.V	TST
MACROPHAGES	TST
DIPSTICK	MTD
MODIFIED ZEIHL NEELSEN STAIN	TST
NITRITE	TST
OCCULT BLOOD	TST
PLATELET DISTRIBUTION WIDTH	TST
PLATELET COUNT	TST
lakhs/cumm	UNT
PROTEIN	TST
Quantity	TST
R.B.C Count	TST
REACTION	TST
Rh TYPE	TST
S.G.O.T.	TST
S.G.P.T.	TST
S.G.P.T. (ALT)	TST
S.G.O.T. (AST)	TST
S. Triglycerides	TST
Serum V.L.D.L.	TST
SPECIFIC GRAVITY	TST
Spermatozoa	TST
URINE SUGAR	TST
WHITE BLOOD CELL	TST
Yeast Cells	TST
Volume	TST